SO ./texture/skyblue_bird.xpm

C 61,183,05

F 100,2,1

NO ./texture/green_bird.xpm
EA ./texture/orange_bird.xpm

WE ./texture/dot_bird.xpm



        1111111111111111111111111
        1011000001110000000000001
        1001000000000000000000001
111111111011000001110000000000001
100000000011000001110111111111111
11110111111111011100000110001
1110111111111011101011000001
11000000110101011100000010001
10000000000000001100000010001
10000000000000001100000000001
1100000111010101111101111000111111111111111
11110111 1110101 101111011011
10000000100000001000000000001
10000000000000000000000000001
10000000000000000000000000001
10000000000000000000N00000001    1111111
10000000000000000000000000001    1000001
10000000000000000000000000001    1111111
10000000000000000000000000001
1111111111111111111111111111
