NO ./texture/green_bird.xpm
SO ./texture/skyblue_bird.xpm
WE ./texture/dot_bird.xpm
EA ./texture/orange_bird.xpm

C 61,183,204
F 102,75,0

        1111111111111111111111111
        1000000000110000000000001
        1011000001110000000000001
        1001000000000000000000001
111111111011000001110000000000001
100000000011000001110111112111111
11110111111111011100000100001
1110111111111011101010000001
11000000110101011100000010401
10000000000000001100000020001
10000000000000001101010010W01
1100000111010101111101111000111
11110111 1110101 101111010001
11111111 1111111 111111111111