NO ./texture/green_bird.xpm
WE ./texture/dot_bird.xpm
S ./texture/skyblue_bird.xpm
EA ./texture/orange_bird.xpm

C 61,183,1
F 102,75,252

        1111111111111111111111111
        1000000000110000000000001
        1011000001110000000000001
        1001000000000000000000001
111111111011000001110000000000001
100000000011000001110111112111111
11110111111111011100000140001
1110111111111011101014000041
11000000110101011100000010001
10000000000000001100000020001
10000000000000001101010010S01
1100000111010101111101111000111
11110111 1110101 101111014041
10000000100000001000000000001
10000000000000000000000000001
10000000000000000000000000001
10000000000000000000000000001    1111111
10000000000000000000000000001    1000001
10000000000000000000000000001    1111111
10000000000000000000000000001
11111111111111111111111111111
